00000000000000000000000000000000000000000000000000
00000000000000000000000000000000000000000000000000
00000000000000000000000000000000000000000000000000
00000000000000000000000000000000000000000000000000
00000000000000000000000000000000000000000000000000
00000000000000000000000000000000000000000000000000
00000000000000000000000000000000000000000000000000
00000000000000000000000000000000000000000000000000
00000000000000000000000000000000000000000000000000
00000000000000000000000000000000000000000000000000
0000000000PGPPP000000000000000PPPPP000000000000000
00000000000000000000000000000000000000000000000000
000000000H00000000PPPPPGPPP00000000000000000000000
000000000000000000000000000000000000BBBB0000000000
000000000000000SS000000000000C000000BBBBB00000F000
11111111111111111111111111111100000011111111111111