000000001000000000000000100000000000000010000000
000000000000000000000000000000000000000000000000
000000001000000000000000000000000000000000000000
000000000000000000000000000000000000000000000000
000000001000000000000000000000000000000000000000
000000000000000000000000000000000000000000000000
010000001000000000000000000000000000000000000000
000000001000000000000000000000000000000000000000
000000000000000000000000000000000000000000000000
000010001111111111000000000000000000000000000000
000010011111111111100000000000000000000000000000
000010011111111111111111111111111100000000000000
0CCC00011111111110000000000000000000000000000000
000000000001110000000000000000000000000000000000
000000000000000101000000000000000000000000000000
11111111110000000C111111111111111111111111111111