00000000000000000000000000000000000000000000000000
00000000000000000000000000000000000000000000000000
00000000000000000000000000000000000000000000000000
00000000000000000000000000000000000000000000000000
00000000000000000000000000000000000000000000000000
00000000000000000000000000000000000000000000000000
00000000000000000000000000000000000000000000000000
00000000000000000000000000000000000000000000000000
00000000000000000000000000000000000000000000000000
00000000000000000000000000000000000000000000000000
0000000000PGPPP000000000000000PPPPP000000000000000
00000000000000000000000000C000000000BB000000000000
000000000H00000000PPPPPGPPP000000000BBB00000000000
000000000000000000000000000000000000BBBB0000000000
000000000000000SS000000000000C000000BBBBB00000F000
11111111111111111111111111111100001111111111111111