00000000000000000000000000000000000000000000000000
00000000000000000000000000000000000000000000000000
00000000000000000000000000000000000000000000000000
00000000000000000000000000000000000000000000000000
00000000000000000000000000000000000000000000000000
00000000000000000000000000000000000000000000000000
00000000000000000000000000000000000000000000000000
00000000000000000000000000000000000000000000000000
00000000000000000000000000000000000000000000000000
00000000000000000000000000000000000000000000000000
0000000PPPPPHHPPPP00000000000000000000000000000000
00000000000000000000000C000000B0000000000000000000
0000000000000000000000PPPPPP00BBB00000000000000000
00000000000000000000PP00000000BBBBBB00000000000000
0000000000000000SS000000000000BBBBBBBB00000000F000
11111111111111111111100000000000001111111111111111