000000001000000000000000100000000000000010000000
000000000000000000000000000000000000000000000000
000000001000000000000000000000000000000000000000
000000000000000000000000000000000000000000000000
000000001000000000000000000000000000000000000000
000000000000000000000000000000000000000000000000
000000001000000000000000000000000000000000000000
000000001000000000000000000000000000000000000000
000000000000000000000000000000000000000000000000
000000001100000000000000000000000000000000000000
000000000000000000000000000000000000000000000000
000000001000000000111111111111111100000000000000
000000000000000000000000000000000000000000000000
000000000000000000000000000000000000000000000000
000000000000000000000000000000000000000000000000
111111111111111111111111111111111111111111111111