0000000010000000
0000000000000000
0000000010000000
0000000000000000
0000000010000000
0000000000000000
0000000010000000
0000000010000000
0000000000000000
0000000011000000
0000000000000000
0000000010000000
0000000000000000
0000000010000000
0000000000000000
1111111111111111